...#.#.....
..##.#.####
.##..###..#
...........
#...@..#..#
###..###..#
..#..#....#
.##.##.#.##
.#......##.
##.....##..
...#.###...